NO ./assets/textures/walls/wall_1.xpm
SO ./assets/textures/walls/wall_2.xpm
WE ./assets/textures/walls/wall_3.xpm
EA ./assets/textures/walls/wall_4.xpm





F 20,30,50
C 21,10,64


11111111111111111111111111111111111111111111111111
10000000000000000001111100000000000011111000000001
10000000000000000001000100000C00000010001000CCC001
100000000000000000010C01000000000000D0001000000001
1111011111111111111100011D111D11111110001111011111
10010100001111111100000000001000000000000001000001
10010100001000000100000000001000000000000001000001
10010100001000000100000000001000000000000001000001
1001010000100000010000C000001000000000000001000001
10010100001111111100000000001000000000000001000001
10010100000000000000001111111111110000000001000001
10010100000000000000001000000000010000000001000001
100101000000000000000010000000000D0000000001000001
100101000000C0000000001000000000010000000001000001
10010111111111111111111000000000011111111111000001
1001000000000000000000D0000000000D000100000000C001
10011111111111111111111000000000011111100000000001
10000000000000001000000000000000000000100000000001
11111111111111101000000000000000000000111111111111
10000000000000001000000000N00000000000100000000001
10000000000000001000000000000000000000100000000001
10000000000000001000000000000000000000100000000001
10000000000000001000000000000000000000D00000000001
11111110111111111111111111111111111111100111111111
10000010100000000000000000000000000000100100000001
10000010100000000000000000000000000000100100000001
100C0010100000000000000000000000000000100100000001
10CCC010100000000000000000000000000000100100000001
100C0010111111111111111111D11111111111100100000001
10000010000000000000001000100010000000000100000001
10000010000000000000001000100000000000000000000001
10000010000000000000001000100010000000000100000001
11111110000000000000001111100011111111111111111111
10000000000000000000000000100000000000000000000001
1000000000C000000000000000100000000000000000000001
10000000000000000000000000D00000000000000000000001
10000000000000000000000000100000000000000000000001
11111111111111111111111111100000000000000000000001
10000000000000000000000000100000000000000000000001
10000000000000000000000000D00000000000000C00000001
10000000000C00000000000000100000000000000000000001
10000000000000000000000000100000000000000000000001
1111D111111111111111111111111111111111111111111111
10000000000000000000000000000000000000000000000001
10000000000000001111111111111111110000000000000001
10000000000000001000000000000000010000000000000001
1000000000000000100000000000000001000000000C000001
10000C00000000001000000C000000000D0000000000000001
100000000000000011111111111111111100000000000C0001
11111111111111111111111111111111111111111111111111
