NO ./assets/textures/walls/wall_1.xpm
SO ./assets/textures/walls/wall_2.xpm
WE ./assets/textures/walls/wall_3.xpm
EA ./assets/textures/walls/wall_4.xpm





F 50,50,50
C 150,150,255


11111111111111111111
10000000000000000001
10000000000000000001
10001D10101010101001
10000000000000000001    11111
10000000000000001001    10001
1000000S000000001001    11101
1000000C000000001001       1
10111000000001101001
10001000000000000001
10000000000000000001
10001000000000000001
11111111111111111111
