NO ./assets/textures/walls/wall-blood.xpm
SO ./assets/textures/walls/wall-moss.xpm
WE ./assets/textures/walls/wall-brick-blue-light-from-top.xpm
EA ./assets/textures/walls/blue-rocks.xpm





F 20,30,50
C 21,10,64


11111111111111111111
10000001100000000001
10001000D01D10101001
1000001D10000C001001
1000001N100000C0D001
10000000000C00001001
11111111111111111111
