NO ./assets/textures/walls/wall_1.xpm
SO ./assets/textures/walls/wall_2.xpm
WE ./assets/textures/walls/wall_3.xpm
EA ./assets/textures/walls/wall_4.xpm





F 20,30,50
C 21,10,64


11111111111111111111
10000001000000000001
1000100D001010101001
10000001000000001001
1000000N000000001001
1000000C000000001001
11111111111111111111
