NO ./assets/textures/walls/wall_1.xpm
SO ./assets/textures/walls/wall_2.xpm
WE ./assets/textures/walls/wall_3.xpm
EA ./assets/textures/walls/wall_4.xpm

F 50,50,50
C 150,150,255

111111111111111111111
100000000000000000001
100000000000000000001
1000000000000N0000001
100000000000000000001
100000C00000000000001
100000000000000000001
100000000000000000001
100000000000000000001
1000000000M0000000001
100000000000000000001
100000000000000000001
111111111111111111111
