NO ./assets/textures/walls/wall_1.xpm
SO ./assets/textures/walls/wall_2.xpm
WE ./assets/textures/walls/wall_3.xpm
EA ./assets/textures/walls/wall_4.xpm

F 20,30,50
C 135,206,235

111111111111111111111
100000000000000000001
100000000000000000001
1000000000000N0000001
10000000000C000000001
100000C0000C000000001
10000000000C000000001
10000000000C000000001
100000000000000000001
1000000000M0000000001
100000000000000000001
100000000000000000001
111111111111111111111
