NO ./assets/textures/walls/wall_1.xpm
SO ./assets/textures/walls/wall_2.xpm
WE ./assets/textures/walls/wall_3.xpm
EA ./assets/textures/walls/wall_4.xpm

F 20,30,50
C 135,206,235


11111111111111111111
10000000000000000001
10000000000000000001
10001010101010101001
10000000000000000001
10000000000000001001
10000000000000001001
10000000000W00001001
101110000000011D1001
10001000000000000001
1000D000000000000001
10001000000000000001
11111111111111111111
