NO ./assets/textures/walls/wall-blood.xpm
SO ./assets/textures/walls/wall-moss.xpm
WE ./assets/textures/walls/wall-brick-blue-light-from-top.xpm
EA ./assets/textures/walls/blue-rocks.xpm
F 20,30,50
C 135,206,235

                                           1111111111111
                            11111111111111 1000000000001
                            10000000000001 1000000000C01
                            1000C000000001 1000000000001
                            10000000000001 1111110111111
                            11111111111101      101
                                       101      101
                                       101      101
                        1111111111111111D11111111D111111111111111111111111
                        100000000000D0000000000000000000D00000000000000001
                        10111111111110000000000000000000111111100000000001
                        101         10000C000000000000001     1C0000000001  1111111111111
                1111111110111111    100000000000000000001     111111111111  1C00000000001
                1000000000000001    100000000000000000001                   1000000000001
                10000C0000000001    10E00000000000000M00111111111111111111111000000000001
                1000000000000001    10000000000000000000D00000000000000000000000000000001
                1111111111111111    10000000000000000000111111111111111111111111111111111
                                    100000000000000000001
                        11111111111110000000000000000000111111111111111111
                        100000000000D0001000000000000000D00000000000000001
                        10001111111111111111D11111111111110000000000000001
                        10001              101           10000000000000001
                        10001              101           10000000000000001
                11111111100011111111  11111101111111     1C0000000000000C1
                10000000000000000001  10000000000001     11111111111111111
                10000000000000000001  10000000000001
                1000000000C000000001  10000000C00001
                10000000000000000001  10000000000001
                11111111111111111111  11111111111111
