NO ./assets/textures/walls/wall_1.xpm
SO ./assets/textures/walls/wall_2.xpm
WE ./assets/textures/walls/wall_3.xpm
EA ./assets/textures/walls/wall_4.xpm

F 20,30,50
C 135,206,235

111111111111111111111111111111111111111111111111111111111111111111111111111111111111111111111111111111111111
100000000000000000000000000000000000000000000000000000000000000000000000000000000000000000000000000000000001
100000000000000000000000000000000000000000000000000000000000000000000000000000000000000000000000000000000001
111000000000001110000000000000000000000000000000000000000000000000000000000000000000000000000000000000000001
101000000000001010000000000000000000000000000000000000000000000000000000000000000000000000000000000000000001
100000000000001110000000000000000000000000000000000000000000000000000000000000000000000000000000000000000001
100000000000000000000001000000000000000000000000000000000000000000000000000000000000000000000000000000000001
10111111111111111000001D000000S00000000000000000000000000000000000000000000000000000000000000000000000000001
100000000000000000000001000000000000000000000000000000000000000000000000000000000000000000000000000000000001
100000000000000000000000000000000000000000000000000000000000000000000000000000000000000000000000000000000001
100000000000000000000000000000000000000000000000000000000000000000000000000000000000000000000000000000000001
100000000000000000000000000000000000000000000000000000000000000000000000000000000000000000000000000000000001
100000000100000000000000000000000000000000000000000000000000000000000000000000010000000000000000000000000001
100000000100000000000000100000000000000000000000000000000000000000000000011111110000000000000000000000000001
100000000100000000000000100000000000000000000000000000000000000110000000010000000000000000000000000000000001
100000000100000000000000100000000000000000000000000001111111111000000001000000000000000000000000000000000001
100000000100000000000000100000000000000000000000000000000000000000000001000000000000000000000000000000000001
100000000100000000000000100000000000000000000000000001111111111100000001000000000000000000000000000000000001
100000000100000000000000100000000000000000000000000000000000000010000001000000000000000000000000000000000001
100000000111111111111111100000000000000000000000000000000000000001111100000000000000000000000000000000000001
100000000000000000000000000000000000000000000000000000000000000000000000000000000000000000000000000000000001
100000000000000000000000000000000000000000000000000000000000000000000000000000000000000000000000000000000001
100000000000000000000000000000000000000000000000000000000000000000000000000000000000000000000000000000000001
100000000000000000000000000000000000000000000000000000000000000000000000000000000000000000000000000000000001
100000000000000000000000000000000000000000000000000000000000000000000000000000000000000000000000000000000001
100000000000000000000000000000000000000000000000000000000000000000000000000000000000000000000000000000000001
100000000000000000000000000000000000000000000000000000000000000000000000000000000000000000000000000000000001
100000000000000000000000000000000000000000000000000000000000000000000000000000000000000000000000000000000001
100000000000000000000111000000000000000000000000000000000000000000000000000000000000000000000000000000000001
100000000000000000000101000000000000000000000000000000000000000000000000000000000000000000000000000000000001
100000000000000000000101000000000000000000000000000000000000000000000000000000000000000000000000000000000001
100000000000000000000101000000000000000000000000000000000000000000000000000000000000000000000000000000000001
100000000000000000000101000000000000000000000000000000000000000000000000000000000000000000000000000000000001
100000000000000000000101000000000000000000000000000000000000000000000000000000000000000000000000000000000001
100000000000000000000101000000000000000000000000000000000000000000000000000000000000000000000000000000000001
100000000000000000000101000000000000000000000000000000000000000000000000000000000000000000000000000000000001
100000000000000000000101000000000000000000000000000000000000000000000000000000000000000000000000000000000001
100000000000000000000101000000000000000000000000000000000000000000000000000000000000000000000000000000000001
100000000000000000000000000000000000000000000000000000000000000000000000000000000000000000000000000000000001
100000000000000000000000000000000000000000000000000000000000000000000000000000000000000000000000000000000001
100000000000000000000000000000000000000000000000000000000000000000000000000000000000000000000000000000000001
100000000000000000000000000000000000000000000000000000000000000000000000000000000000000000000000000000000001
100000000000000000000000000000000000000000000000000000000000000000000000000000000000000000000000000000000001
100000000000000000000000000000000000000000000000000000000000000000000000000000000000000000000000000000000001
100000000000000000000000000000000000000000000000000000000000000000000000000000000000000000000000000000000001
100000000000000000000000000000000000000000000000000000000000000000000000000000000000000000000000000000000001
100000000000000000000000000000000000000000000000000000000000000000000000000000000000000000000000000000000001
100000000000000000000000000000000000000000000000000000000000000000000000000000000000000000000000000000000001
111111111111111111111111111111111111111111111111111111111111111111111111111111111111111111111111111111111111
