NO ./assets/textures/walls/north.xpm
SO ./assets/textures/walls/south.xpm
WE ./assets/textures/walls/west.xpm
EA ./assets/textures/walls/east.xpm

F 20,20,20
C 200,200,200

111111111111111111111
100000000000000000001
100000000000000000001
1000000000000N0000001
100000000000000000001
100000000000000000001
100000000000000000001
1000D0000D00000000001
1000000000D0000000001
100000000000000000001
100000000000000000001
100000000000000000001
111111111111111111111
