NO ./assets/textures/walls/wall_1.xpm
SO ./assets/textures/walls/wall_2.xpm
WE ./assets/textures/walls/wall_3.xpm
EA ./assets/textures/walls/wall_4.xpm

F 76,76,76
C 173,173,173

11111111111111111111
10000000000000000001
10000000000000000001
100N1010101010101001
10000000000000000001
100000000000b0001001
1000000p000000001001      11111
10000000000000001001      10001
101110000000011D1001      10111
10001000000000000001
1000D000000000000001
10001000000000000001
11111111111111111111
