NO ./assets/textures/walls/wall_1.xpm
SO ./assets/textures/walls/wall_2.xpm
WE ./assets/textures/walls/wall_3.xpm
EA ./assets/textures/walls/wall_4.xpm

F 255,255,255
C 255,0,0





11111111111111111111
10000000000000000001
10000000000000000001
100M1010101010101001
10000000000000000001
10000000000000001001
10000000000000001001
10000000000000001001
10000000000001111001
10000NM0000000000001
10000000000000000001
10000000000000000001
11111111111111111111
