NO ./assets/textures/walls/wall_1.xpm
SO ./assets/textures/walls/wall_2.xpm
WE ./assets/textures/walls/wall_3.xpm
EA ./assets/textures/walls/wall_4.xpm





F 50,50,50
C 150,150,255


11111111111111111111
10000000000000000001
100000M0000000000001
10001010101010101001
10000000000000000001    11111
10000000000000001001    10001
1000000N000000001001    11101
10000000010000001001       1
101110001D10011D1001
10001000010000000001
1000D000000000000001
100010000000000000M1
11111111111111111111
