NO ./assets/textures/walls/wall_1.xpm
SO ./assets/textures/walls/wall_2.xpm
WE ./assets/textures/walls/wall_3.xpm
EA ./assets/textures/walls/wall_4.xpm

F 76,76,76
C 173,173,173

00000000000000000000
00000000000000000000
00000000000000000000
000N1010101010101000
00000000000000000000
000000000000b0001000
0000000p000000001000
00000000000000001000
001110000000011D1000
00001000000000000000
0000D000000000000000
00001000000000000000
00000000000000000000
